蓮	莲	player's name, boy
香純	香纯
アナウンサー	播音员
玲愛	玲爱
神父	神父
螢	萤
司狼	司狼
戒	戒
マリィ	玛莉
ルサルカ	露萨卢卡
ラインハルト	莱因哈特
エリー	艾莉
トリファ	托里法
ヴィルヘルム	威廉
リザ	莉莎
シュライバー	施赖伯
マキナ	马基那
エレオノーレ	艾莱奥诺莱
レン	莲	player's name, boy
カイン	凯因
ハイドリヒ	海德里希
メルクリウス	梅尔克里乌斯
イザーク	伊萨克
ベアトリス	贝阿朵丽丝
シュピーネ	舒庇涅
ベイ	贝
トバルカイン	托巴尔凯因
テレジア	特蕾西亚
アンナ	安娜
ヴァレリア	瓦雷利亚
カール	卡尔
ザミエル	扎米尔
クリストフ	克里斯托夫
クラフト	克拉夫特
レオンハルト	莱昂哈特
レベル	雷贝尔
バビロン	巴比伦
ゾーネンキント	佐南金索
タワー	塔
レオン	莱昂
ツァラトゥストラ	查拉图斯特拉
ヴァルハラ	瓦尔哈拉
ドイツ	德国
カリオストロ	卡里奥斯特罗
カスミ	香纯
キルヒアイゼン	吉尔希森
マルグリット	玛格丽特
ベルリン	柏林
ルール	卢尔
ブレンナー	布伦纳
ヨハン	约翰
ヴァルキュリア	瓦尔基里亚
グラズヘイム	格拉兹海姆
ウォルフガング	沃尔夫冈
シャンバラ	香巴拉
エーレンブルグ	埃伦堡

エインフェリア	英灵
ロートス	罗特斯  man
ヴァルター	瓦尔特  boy
エイヴィヒカイト	艾维希凯特
フォン	冯  
ヴィッテンブルグ	威登堡
マシ	马西
聖餐杯  圣餐杯  man
